####################
#..................#
#..M...........M...#
#..................#
#....C.........C...#
#..................#
#........@.........#
#..................#
#...1..........2...#
#..................#
####################