###################################################################
#.................g...#         #.................................#
#..###########........#         #..#######################......g.#
#..#.........#........###########..#                     #........#
#..#....@....D........#............#                     #....Z...#
#..#.........#........D............#                     #........#
#..###########........#######D######                     ##########
#.......O.............#     #.#
#######################     #.#
                            #.#              ######################
                            #.#              #....................#
       ######################D################....................#
       #.....................................D....................#
       #..############.......................#....................#
       #..#          #.......................#.........O..........#
       #..#          #........O..............#....................#
       #..#          #.................C.....#....................#
       #..#          #########################..................C.#
       #..#                                  #....................#
       #..#                                  ##################D###
       #..#                                                  #..#
       #..#           ########################################..#
       #..#           #.........................................#
       #..#############.....R...............g...................#
       #................................C..................s....#
       ################D#########################################
                      #.#
                      #.#
       ################D########################################
       #.......................................................#
       #..##################################################...#
       #..#                                                #...#
       #..#                                                #...#
       #..#                                                #...#
       #..#                                                #.R.#
       #..#                                                #...#
       #..#                                                #...#
       #..##################################################...#
       #.s........................C...........................=#
       #########################################################
