########
#123CCC#
#......#
#.....@#
###D##########
#..........Dg#
#..........###
#..........Ds#
#..........###
#..........DZ#
#..........###
#..........DO#
#..........###
#..........DR#
#####D########
  #.....#
  #..=..#
  #######